00000000000000000000000000000000000000000000000000
00000000000000000000000000000000000000000000000000
00000000000000000000000000000000000000000000000000
00000000000000000000000000000000000000000000000000
00000000000000000000000000000000000000000000000000
00000000000000000000000000000000000000001227223000
00000000000000000000000000000000000000000007000000
00000000000000000000000000000000000000000007000000
00000000000000000000000000000000000000000007000000
00000000000000130000000122222230000000000007000000
00000000000000440000000000000000000000000007000000
00000000001222552223000000000000001230000007000000
00000000004444554444000000000000004440000007000000
12222222225555555555222222222222225550000122222223
44444444445555555555444444444444445556666444444444